Apple Watch Series 5

*Màn hình
Công nghệ màn hình :	OLED
Kích thước màn hình :	1.78 inch
Độ phân giải :	448 x 368 pixels
Chất liệu mặt :	Ion-X strengthened glass
Đường kính mặt :	44 mm

*Cấu hình
CPU :	Apple S5 64 bit
Bộ nhớ trong :	32 GB
Hệ điều hành :	watchOS 6.0
Kết nối được với hệ điều hành :	iOS 13 trở lên
Cổng sạc :	Đế sạc nam châm
Pin :
Thời gian sử dụng pin :	Khoảng 1.5 ngày
Thời gian sạc :	Khoảng 2 giờ
Dung lượng pin :	Đang cập nhật

*Tiện ích & kết nối
Tính năng cho sức khỏe :	Đo nhịp tim, Tính lượng calories tiêu thụ, Đếm số bước chân, Chế độ luyện tập, Tính quãng đường chạy
Hiển thị thông báo :	Cuộc gọi, Nội dung tin nhắn, Tin nhắn, Zalo, Messenger (Facebook), Line, Viber
Tiện ích khác :	Nghe gọi trên đồng hồ, Nghe nhạc với tai nghe Bluetooth, Màn hình luôn hiển thị, La bàn, Đồng hồ bấm giờ, Điều khiển chơi nhạc, Rung thông báo, Thay mặt đồng hồ, Phát hiện té ngã, Báo thức, Từ chối cuộc gọi
Kết nối :	Bluetooth v5.0, Wifi, GPS
Camera	: Không có

*Dây đeo
Độ dài dây :	Đang cập nhật
Độ rộng dây :	Đang cập nhật
Dây có thể tháo rời :	Có
Chất liệu dây :	Silicon

*Thông tin khác
Chất liệu khung viền :	Nhôm
Kích thước :	Đường kính 44 mm - Dày 10.7 mm
Trọng lượng :	36.7 gram
Ngôn ngữ :	Tiếng Việt, Tiếng Anh